{
  "width": 8,
  "height": 6,
  "tiles": [2, 2, 2, 2, 3, 3, 3, 3,
            2, 2, 2, 2, 3, 3, 3, 3,
            2, 2, 2, 2, 3, 3, 3, 3,
            2, 2, 2, 2, 3, 3, 3, 3,
            4, 4, 4, 4, 4, 4, 4, 4,
            4, 4, 4, 4, 4, 4, 4, 4]
}
